[GRID_SIZE]
2832	640
[OBJECTS]
1	0	0	48	222	1	
0	0	1	0	-192	2	16	432	
1	0	1	0	238	2	624	48	
1	4	1	624	222	2	464	16	
1	8	1	1152	238	2	368	48	
1	11	1	1552	238	2	80	48	
1	12	1	1680	238	2	560	48	
1	16	1	2272	238	2	544	48	
1	17	1	2336	206	2	32	32	
0	10	1	1424	14	2	64	16	
0	11	1	1504	-2	2	176	16	
1	11	1	1520	158	2	32	16	
1	11	1	1584	222	2	48	16	
1	11	1	1600	206	2	32	16	
1	11	1	1616	190	2	16	16	
1	12	1	1680	222	2	48	16	
1	12	1	1680	206	2	32	16	
1	12	1	1680	190	2	16	16	
1	16	1	2272	190	2	32	48	
0	16	1	2272	-18	2	32	160	
2	14	1	1984	286	2	128	192	
3	15	1	2112	446	2	384	32	
3	16	1	2240	430	2	256	16	
3	16	1	2256	414	2	240	16	
2	16	1	2272	398	2	224	16	
2	16	1	2288	382	2	208	16	
2	16	1	2304	366	2	192	16	
2	17	1	2320	350	2	176	16	
2	17	1	2368	286	2	128	64	
2	15	1	2144	286	2	192	16	
1	1	2	176	174	3	0	0	
1	1	2	192	174	3	0	0	
0	1	2	224	126	3	0	0	
0	1	2	240	126	3	1	0	
1	3	2	416	142	3	0	0	
1	4	2	656	206	3	1	0	
1	5	2	704	174	3	0	0	
0	10	2	1456	-34	3	0	1	
1	10	2	1472	190	3	1	0	
1	14	15	1952	222	16	
1	14	15	1968	222	16	
1	14	15	1984	222	16	
1	14	15	2000	222	16	
1	14	15	2016	222	16	
1	14	15	2032	222	16	
1	15	15	2048	222	16	
1	14	15	1968	206	16	
1	14	15	1984	206	16	
1	14	15	2000	206	16	
1	14	15	2016	206	16	
1	14	15	2032	206	16	
1	14	15	1984	190	16	
1	14	15	2000	190	16	
1	14	15	2016	190	16	
1	14	16	2032	190	16	
1	15	15	2096	222	16	
1	15	15	2096	206	16	
1	15	15	2112	222	16	
1	1	3	240	190	2	48	0	
1	2	3	272	158	2	48	0	
1	2	3	400	190	2	80	0	
1	3	3	464	158	2	64	0	
0	3	3	512	126	2	64	0	
1	3	3	512	206	2	96	0	
1	9	3	1280	206	2	112	0	
1	9	3	1312	174	2	112	0	
1	9	3	1344	142	2	112	0	
0	9	3	1328	-18	2	64	0	
1	15	3	2144	190	2	48	0	
0	16	3	2176	94	2	48	0	
1	2	4	320	222	7	
1	4	4	528	222	7	
1	6	4	848	206	7	
1	6	4	896	206	7	
1	7	13	960	206	7	
1	3	5	528	174	8	0	
1	15	5	2096	174	8	0	
1	10	5	1488	206	8	1	
0	9	17	1344	110	8	1	
0	10	17	1392	110	8	1	
0	10	17	1440	110	8	1	
1	8	8	1088	142	12	
0	8	8	1120	110	12	
0	8	8	1152	78	12	
0	8	8	1184	46	12	
0	8	8	1216	14	12	
0	9	8	1344	-98	12	
0	10	8	1360	-98	12	
0	10	8	1376	-98	12	
0	10	8	1488	-66	12	
0	11	8	1504	-66	12	
0	11	8	1552	-50	12	
0	11	8	1568	-50	12	
0	11	8	1584	-50	12	
0	11	8	1600	-50	12	
0	12	8	1632	-66	12	
0	12	8	1648	-66	12	
0	12	8	1664	-66	12	
0	12	8	1680	-66	12	
0	12	8	1712	-34	12	
0	12	8	1744	-66	12	
0	13	8	1776	-50	12	
2	16	8	2192	326	12	
2	16	8	2192	390	12	
2	16	8	2208	310	12	
2	16	8	2224	310	12	
2	16	8	2208	358	12	
2	16	8	2224	358	12	
2	16	8	2208	406	12	
2	16	8	2224	406	12	
2	16	8	2240	326	12	
2	16	8	2240	342	12	
2	16	8	2240	374	12	
2	16	8	2240	390	12	
1	13	11	1816	208	13	
1	2	12	360	190	14	0	
1	13	12	1880	198	14	1	
1	2	14	352	190	6	32	48	0	1	
1	13	14	1808	206	6	32	32	0	0	
1	13	14	1872	190	6	32	48	0	0	
0	16	14	2272	-66	6	32	48	0	1	
1	17	14	2336	206	6	32	32	0	0	
2	15	14	2112	286	6	32	32	1	0	
2	17	14	2336	286	6	32	32	1	1	
1	19	18	2704	158	18	