2576	432
1	0	0	48	222	1	
0	0	1	0	-192	2	16	432	
1	0	1	0	238	2	624	48	
1	4	1	624	222	2	464	16	
1	8	1	1152	238	2	368	48	
1	11	1	1552	238	2	80	48	
1	12	1	1680	238	2	560	48	
1	16	1	2272	238	2	544	48	
1	17	1	2336	206	2	32	32	
0	10	1	1424	14	2	64	16	
0	11	1	1504	-2	2	176	16	
